WWWWWWWWWWWWWWDDDDWWWWWWWWWWWWWW
WWWWWWWWWWWWWWRRRRWWWWWWWWWWWWWW
WWWWWWWWWWWWWWRRRRWWWWWWWWWWWWWW
WWWWWWWWWWWWWWRRRRWWWWWWWWWWWWWW
WWWWWWWWWWWWWWRRRRWWWWWWWWWWWWWW
WWWWWWWWWWWWWWRRRRWWWWWWWWWWWWWW
WWWWWWWWWWWWWWRRRRWWWWWWWWWWWWWW
WWWWWWWWWWWWWWRRRRWWWWWWWWWWWWWW
WWWWWWWWWWWWWWRRRRWWWWWWWWWWWWWW
WWWWWWWWWWWWWWRRRRWWWWWWWWWWWWWW
WWWWWWWWWWWWWWWRRRRWWWWWWWWWWWWW
WWWWWWWWWWWWWWWWRRRRWWWWWWWWWWWW
WWWWWWWWWWWWWWWWWRRRRWWWWWWWWWWW
WWWWWWWWWWWWWWWWWRRRRWWWWWWWWWWW
WWWWWWWWWWWWWWWWWWWRRRRWWWWWWWWW
WFFFFFFFFFFFFFFFFFFFRRRRFFFFFFFW
WWWFFFFFFFFFFFFFFFFFFRRRRFFFFFFW
WWWWFFFFFFFFFFFFFFFFFFRRRRFFFFFW
WWWWFFFFFFFFFFFFFFFFFFFRRRRFFFFW
WWFFFFFFFFFFFFFFFFFFFFFFRRRRFFFW
WFFFFFFFFFFFFFFFFFFFFFFFFRRRRFFW
WFFFFFFFFFFFFFFFFFFFFFFFFFRRRRFW
WFFFFFFFFFFFFFFFFFFFFFFFFFRRRRFW
WFFFFFFFFFFFFFFSSFFFFFFFFFRRRRFW
WFFFFFFFFFFFFFSSSSSFFFFFFFRRRRFW
WFFFFFFFFFFFFSSSSSSFFFFFFFRRRRFW
WFFFFFFFFFFFFSSSSSSFFFFFFFRRRRFW
WFFFFFFFFFFFFFSSSSFFFFFFFFRRRRFW
WFFFFFFFFFFFFFFFFFFFFFFFFFRRRRFW
WFFFFFFFFFFFFFFFFFFFFFFFFFRRRRFW
WFFFFFFFFFFFFFFFFFFFFFFFFFRRRRFW
WFFFFFFFFFFFFFFFFFFFFFFFFFRRRRFW
WFFFFFFFFFFFFFFFFFFFFFFFFFRRRRFW
WFFFFFFFFFFFFFFFFFFFFFFFFFRRRRFW
WFFFFFFFFFFFFFFFFFFFFFFFFFRRRRFW
WFFFFFFFFFFFFWWWWWWWWWWWWWWWWWWW
WFFFFFFFFFFFFWWWWWWWWWWWWWWWWWWW
WFFFFFFFFFFFFFFFFFFFFFFFFFRRRRFW
WFFFFFFFFFFFFFFFFFFFFFFFFFRRRRFW
WFFFFFFFFFFFFFFFFFFFFFFFFFRRRRFW
WFFFFFFFFFFFFFFFFFFFFFFFFFRRRRFW
WFFFFFFFFFFFFFFFFFFFFFFFFFRRRRFW
WFFFFFFFFFFFFFFFFFFFFFFFFRRRRFFW
WFFFFFFFFFFFFFFFFFFFFFFFRRRRFFFW
WFFFFFFFFFFFFFFFFFFFFFFRRRRFFFFW
WWWWWWWWWWWWWWWWWWWFFFRRRRFFFFFW
WWWWWWWWWWWWWWWWWWWFFRRRRFFFFFFW
WFFFFFFFFFFFFFFFFFFFRRRRFFFFFFFW
WFFFFFFFFFFFFFFFFFFRRRRFFFFFFFFW
WFFFFFFFFFFFFFFFFFRRRRFFFFFFFFFW
WFFFFFFFFFFFFFFFFRRRRFFFFFFFFFFW
WFFFFFFFFFFFFFFFRRRRFFFFFFFFFFFW
WFFFFFFFFFFFFFFRRRRFFFFFFFFFFFFW
WFFFFFFFFFFFFFFRRRRFFFFFFFFFFFFW
WFFFFFFFSSSFFFFRRRRFFFFFFFFFFFFW
WFFFFFFSSSSSFFFRRRRFFFFFFFFFFFFW
WFFFFFFSSSSSSFFRRRRFFFFFFFFFFFFW
WFFFFFFFSSSSFFFRRRRFFFFFFFFFFFFW
WFFFFFFFFSSFFFFRRRRFFFFFFFFFFFFW
WFFFFFFFFFFFFFFRRRRFFFFFFFFFFFFW
WFFFFFFFFFFFFFFRRRRFFFFFFFFFFFFW
WWFFFFFFFFFFFFFRRRRFFFFFFFFFFFFW
WWWFFFFFFFFFFFFRRRRFFFFFFFFFFFFW
WWWWFFFFFFFFFFFRRRRFFFFFFFFFFFFW
WWWFFFFFFFFFFFRRRRSSFFFFFFFFFFFW
WFFFFFFFFFFFFRRRRSSSSFFFFFFFFFFW
WFFFFFFFFFFFRRRRSSSSSSFFFFFFFFFW
WFFFFFFFFFFRRRRSSSSSSSFFFFFFFFFW
WFFFFFFFFFRRRRFFSSSSSFFFFFFFFFFW
WFFFFFFFFRRRRFFFFSSSFFFFFFFFFFFW
WFFFFFFFFRRRRFFFFFFFFFFFFFFFFFFW
WFFFFFFFFRRRRFFFFFFFFFFFFFFFFFFW
WWWFFFFFFRRRRFFFFFFFFFFFFFFFFFFW
WWWFFFFFFRRRRFFFFFFFFFFFFFFFFFWW
WFFFFFFFFRRRRFFFFFFFFFFFFFFFFWWW
WFFFFFFFFRRRRFFFFFFFFFFFFFFFWWWW
WFFFFFFFFRRRRFFFFFFFFFFFSSSWWWWW
WFFFFFFFFRRRRFFFFFFFFFFFSSSSWWWW
WFFFFFFFFRRRRFFFFFFFFFFSSSSSWWWW
WFFFFFFFFRRRRFFFFFFFFFFFSSSWWWWW
WFFFFFFFFRRRRFFFFFFFFFFFFFSWWWWW
WFFFFFFFFRRRRFFFFFFFFFFFFFFFWWWW
WFFFFFFFFRRRRFFFFFFFFFFFFFFFFWWW
WFFFFFFFFRRRRFFFFFFFFFFFFFFFFFWW
WWWFFFFFFRRRRFFFFFFFFFFFFFFFFFFW
WWFFFFFFFRRRRFFFFFFFFFFFFFFFFFFW
WWWFFFFFFRRRRFFFFFFFFFFFFFFFFFFW
WFFFFFFFFFRRRRFFFFFFFFFFFFFFFFFW
WFFFFFFFFFFRRRRFFFFFFFFFFFFFFFFW
WFFFFFFFFFFFRRRRFFFFFFFFFFFFFFFW
WFFFFFFFFFFFFRRRRFFFFFFFFFFFFFFW
WFFFFFFFFFFFFFRRRRFFFFFFFFFFFFFW
WFFFFFFFFFFFFFRRRRSFFFFFFFFFFFFW
WFFFFFFFFFFFFFRRRSSFFFFFFFFFFFFW
WFFFFFFFFFFFFFRRRSSFFFFFFFFFFFFW
WWWFFFFFFFFFFFRRRRFFFFFFFFFFFFFW
WWWWWFFFFFFFFFRRRRFFFFFFFFFFFFFW
WWWWFFFFFFFFFFRRRRFFFFFFFFFFFFWW
WWWWFFFFFFFFFFRRRRFFFFFFFFFFWWWW
WWWFFFFFFFFFFFRRRRFFFFFFFFFFFWWW
WFFFFFFFFFFFFFRRRRFFFFFFFFFFFFFW
WFFFFFFFFFFFFFFRRRRFFFFFFFFFFFFW
WFFFFFFFFFFFFFFFRRRRFFFFFFFFFFFW
WFFFFFFFFFFFFFFFFRRRRFFFFFFFFFFW
WFFFFFFFFFFFFFFSFFRRRRFFFFFFFFFW
WFFFFFFFFFFFFFSSFFRRRRFFFFFFFFFW
WFFFFFFFFFFFFSSSSFRRRRFFFFFFFFFW
WFFFFFFFFFFFFFSSSFRRRRFFFFFFFFFW
WFFFFFFFFFFFFFSSFFRRRRFFFFFFFFFW
WFFFFFFFFFFFFFFFFRRRRFFFFFFFFFFW
WFFFFFFFFFFFFFFFRRRRFFFFFFFFFFFW
WWWWFFFFFFFFFFFRRRRFFFFFFFFFFFWW
WWWFFFFFFFFFFFRRRRFFFFFFFFFFFWWW
WWWFFFFFFFFFFFRRRRFFFFFFFFFFFFWW
WWWWWWWWWWWWWWRRRRWWWWWWWWWWWWWW
WWWWWWWWWWWWWWRRRRWWWWWWWWWWWWWW
WWWWWWWWWWWWWWRRRRWWWWWWWWWWWWWW
WWWWWWWWWWWWWWRRRRWWWWWWWWWWWWWW
WWWWWWWWWWWWWWRRRRWWWWWWWWWWWWWW
WWWWWWWWWWWWWWRRRRWWWWWWWWWWWWWW