	








































                                                                                                1!!!!!!!!!!!i!!!!!!!!!!!2
                                                                                                69@@9@@9@@9@@@9@@9@@9@@97
                                                                                                6@@@@@@@@@@@@@@@@@@@@@@@7
                                                                                                6@@@@@@@@@@@@@@@@@@@@@@@7
                                                                                                6@@@@@@@@@@@@@@@@@@@@@@@7
                                                                                                6@@@@@@@@@@@@@@@@@@@@@@@7
                                                                                                6@@@@@@@@@@@@@@@@@@@@@@@7
                                                                                                6@@@@@@@@@@@@@@@@@@@@@@@7
                                                                                                6@@@@@@@@@@@@@@@@@@@@@@@7
                                                                                                6@@@@@@@@@@@@@@@@@@@@@@@7
                                                                                                6@@@@@@@@@@@@@@@@@@@@@@@7
                                                                                                6@@@@@@@@@@@@@@@@@@@@@@@7
                                                                                                6@@@@@@@@@@@@@@@@@@@@@@@7
                                                                                                6@@@@@@@@@@@@@@@@@@@@@@@7
                                                                                                6@@@@@@@@@@@@@@@@@@@@@@@7
                                                                                                6@@@@@@@@@@@@@@@@@@@@@@@7
                                                                                                6@@@@@@@@@@@@@@@@@@@@@@@7
                                                                                                6@@@@@@@@@@@@@@@@@@@@@@@7
                                                                                                3!!!!!!!!!!!p!!!!!!!!!!!4

