TTTTTTTTTTTTTTTTTTTTTTTTLAARTTTTTTTTTTTTTTTTTTTHZZZZZZZZZGTTTTTTTTTTTTTTTTTTTT
TTTTTTTTTTTTTTTTTTTTTTTTLAARTTTTTTTTTTTTTTTTTTTHZZZZZZZZZGTTTTTTTTTTTTTTTTTTTT
TTTCCCCCCCCCCCCCCCCCCCCCLAARCCCCCCTTTTTTTTTTTTTHZZZZZZZZZGCCCCCCCCCCCCTTTTTTTT
TTTCCCCCCCCCCCCCCCCCCCCCLAARCCCCCTTTTTTTTTTTTTTHZZZZZZZZZGCCCCCCCCCCCCTTTTTTTT
TTTCCCCCCCCCCCCCCCCCCCCCLAARCCCCCTTTTTTTTTTTTCCHZZZZZZZZZGCCCCCCCCCCCCTTTTTTTT
TTTCCCCCCCCCCCCCCCCCCCCCLAARCCCCCCTTTTTTTTTTTCCPEEEEBEEEENCCCCCCCCCCCCTTTTTTTT
TTTCCCCCCCCCCCCCCWWWWWWWIYYFWWWWWWWWWWWWWWWWWWWWWWWWWWWWWWWWWCCCCCCCCCCCCCCTTT
TTTCCCCCCCCCCCCCCWWWWWWWKMMVWWWWWWWWWWWWWWWWWWWWWWWWWWWWWWWWWCCCCCCCCCCCCCCTTT
TTTCCCCCCCCCCCCCCWWWCCCCLAARCCCCCCTTTTTTTTTTTTCCCCCCCCCCCCCCCCCCCCCCCCCCCCCTTT
TTTCCCCCCCCCCCCCCWWWCCCCLAARCCCCCCTTTTTTTTTTTTCCCCCCCCCCCCCCCCCCCCCCCCCCCCCTTT
TTTCCCCCCCCCCCCCCWWWCCCCLAARCCCCCCCCCCTTTTTTCCCCCCCCCCCCCCCCCCCCCCCCCCCCCCCTTT
TTTCCCCCCCCCCCCCCWWWCCCCLAARCCCCTTTTTTTTTTTTCCCCCCCCCCCCCCCCCCCCCCCCCCCCCCCTTT
TTTCCCCCCCCCCCCCCWWWCCCCLAARCCCTTTTTTTTTTTTCCCCCCCCCCCCCCCCCCCCCCCCCCCCCCCCTTT
TTTCCCCCCCCCCCCCCWWWCCCCLAARCCCTTTTTTTTTCCCCCCCCCCCCCCCCCCCCCCCCCCCCCCCCCCCTTT
TTTCCCCCCCCCCCCCCWWWCCCCLAARCCTTTTTTTTTTTTTTTCCCCCCCCCCCCCCCCCCCCCCCCCCCCCCTTT
TTTCCCCCCCCCCCCCCWWWCCCCLAARCCCTTTTTTTTTTTTTTTCCCCCCCCCCCCCCCCCCCCCCCCCCCCCTTT
TTTCCCCCCCCCCCCCCWWWCCCCLAARCCTTTTTTTTTTTTTTTCCCCCCCCCCCCCCCCCCCCCCCCCCCCCCTTT
TTTCCCCCCCCCCCCCCWWWCCCCLAARCCTTTTTTTTTTTTTTTCCCCCCCCCCCCCCCCCCCCCCCCCCCCCCTTT
TTTCCCCCCCCCCCCCCWWWCCCCLAARCCTTTTTTTTTTTTTTTCCCCCCCCCCCCCCCCCCCCCCCCCCCCCCTTT
TTTCCCCCCCCCCCCCCWWWCCCCLAARCCCCTTTTTTTTTTTTTTTCCCCCCCCCCCCCCCCCCCCCCCCCCCCTTT
TTTCCCCCCCCCCCCCCWWWWWWWIYYFWWWWWWWWWWWWWWWWWCCCCCCCCCCCCCCCCCCCCCCCCCCCCCCTTT
TTTCCCCCCCCCCCCCCWWWWWWWKMMVWWWWWWWWWWWWWWWWWCCCCCCCCSQXCCCCCCCCCCCCCCCCCCCTTT
TTTCCCCCCCCCCCCCCWWWCCCCLAARCCCCTTTTTTTTTTWWWTTCCCCCCUJUCCCCCCCCCCCCCCCCCCCTTT
TTTCCCCCCCCCCCCCCWWWCCCCLAARCCTTTTTTTTTTTTWWWTTTTCCCCQDQCCCCCCCCCCCCCCCCCCCTTT
TTTCCCCCCCCCCCCCCWWWCCCCLAARCCTTTTTTTTTTTTWWWWWWWWWWWWWWWCCCCCCCCCCCCCCCCCCTTT
TTTCCCCCCCCCCCCCCWWWCCCCLAARTTTTTTTTTTTTTTWWWWWWWWWWWWWWWCCCCCCCCCCCCCCCCCCTTT
TTTCCCCCCCCCCCCCCWWWCCCCLAARTTTTTTTTTTTTTTTTTTCCCCCCCCCCCCCCCCCCCCCCCCCCCCCTTT
TTTTTTTTTTTTTTTTTTTTTTTTLAARTTTTTTTTTTTTTTTTTTTCCCCCCCCCCCCCCCCCCCCCCCCCCCCTTT
TTTTTTTTTTTTTTTTTTTTTTTTLAARTTTTTTTTTTTTTTTTTTTTTTTTTTTTTTTTTTTTTTTTTTTTTTTTTT
TTTTTTTTTTTTTTTTTTTTTTTTLAARTTTTTTTTTTTTTTTTTTTTTTTTTTTTTTTTTTTTTTTTTTTTTTTTTT
